m,m,m,m,p,p,p,p,p,p,p,p,p,p,p
m,h_1,b_1,m,p,p,t,p,p,p,p,p,p,p,p
m,b_1,p,m,p,f,p,p,p,p,p,p,t,p,p
m,m,p,p,t,f,p,p,p,p,p,p,p,p,p
p,p,p,p,f,p,p,b,p,p,p,p,p,p,p
p,t,p,p,p,p,r,r,r,p,p,t,p,p,p
p,p,p,p,p,r,r,t,r,r,p,p,p,p,p
p,p,p,b,r,r,t,b,t,r,r,b,p,p,p
p,p,p,p,p,r,r,t,r,r,p,p,p,p,p
p,p,p,t,p,p,r,r,r,p,p,p,p,t,p
p,p,p,p,p,p,p,b,p,p,p,p,p,p,p
p,p,t,p,p,p,p,p,p,p,p,p,w,w,w
p,p,p,p,p,p,p,p,p,p,p,w,p,b_2,w
p,p,p,p,p,p,t,p,p,p,w,b_2,h_2,w,w
p,p,p,p,p,p,p,p,p,p,w,w,w,w,w
