h_1,p,p,p,p,p,b,p,p,p,p,p,b_1
p,p,p,o,p,p,p,p,p,o,p,o,p
p,p,b_1,p,m,p,m,p,m,o,p,p,p
p,o,p,t,m,p,m,p,m,t,o,o,p
p,p,m,m,m,p,m,p,m,m,m,p,p
p,f,p,f,p,f,b,f,p,f,p,f,p
p,p,m,m,m,p,m,p,m,m,m,p,p
p,o,o,t,m,p,m,p,m,t,p,o,p
p,p,p,o,m,p,m,p,m,p,b_2,p,p
p,o,p,o,p,p,p,p,p,o,p,p,p
b_2,p,p,p,p,p,b,p,p,p,p,p,h_2
