h_1,b_1,p,p,t,p,p,p,p,t,p,p,b_2,h_2
b_1,p,p,f,p,p,t,t,p,p,f,p,p,b_2
p,p,t,p,p,b,p,p,b,p,p,t,p,p
p,f,p,p,t,p,p,p,p,t,p,p,f,p
t,p,p,t,p,p,b,b,p,p,t,p,p,t
p,p,b,p,p,t,p,p,t,p,p,b,p,p
p,t,p,p,b,p,t,t,p,b,p,p,t,p
p,t,p,p,b,p,t,t,p,b,p,p,t,p
p,p,b,p,p,t,p,p,t,p,p,b,p,p
t,p,p,t,p,p,b,b,p,p,t,p,p,t
p,f,p,p,t,p,p,p,p,t,p,p,f,p
p,p,t,p,p,b,p,p,b,p,p,t,p,p
b_1,p,p,f,p,p,t,t,p,p,f,p,p,b_2
h_1,b_1,p,p,t,p,p,p,p,t,p,p,b_2,h_2
